000000000000000
000000000000000
000000000000000
000011111110000
003333333333300
003222222222300
003221111122300
000000000000000
000000000000000
000000000000000
000000000000000
003221111122300
003222222222300
003333333333300
000011111110000
000000000000000
000000000000000
000000000000000
000000000000000
000000000000000
000000000000000
000000000000000
000000000000000
000000000000000