011111111111100
001111111111100
001111111111100
002222222222200
002222222222200
002222222222200
002222222222200
001111111111100
001111111111100
001111111111100
001111111111100
001111111111100
000000000000000
000000000000000
000000000000000
000000000000000
000000000000000
000000000000000
000000000000000
000000000000000
000000000000000
000000000000000
000000000000000
000000000000000