111111111111000
000110011000001
001100001100000
001100001100001
000113311000000
000012210000001
000011110000000
011100001110000
011100001110001
022200002220000
011100001110000
011100001110000